5 5
*****
*S* *
* * *
*  F*
*****