11 21
*********************
*S    *     *       *
* *** * *** * ***** *
* *   *   *   * *   *
* ******* *** * * * *
*   *   *   *   * * *
*** * *** * ***** * *
*     *   *   *     *
* ***** * ***** *****
*       *   *      F*
*********************